40;40;20;3;10;20;5000;15;15
########################################
#..................##..................#
#..................##..................#
#..................##..................#
#..................##..................#
#..................##..................#
#..................##..................#
#......................................#
#......................................#
#......................................#
#......................................#
#..................##..................#
#..................##..................#
#..................##..................#
#..................##..................#
#..................##..................#
#..................##..................#
#..................##..................#
#..................##..................#
########...#############################
########...#############################
#..................##..................#
#..................##..................#
#..................##..................#
#..................##..................#
#..................##..................#
#..................##..................#
#......................................#
#......................................#
#......................................#
#......................................#
#..................##..................#
#..................##..................#
#..................##..................#
#..................##..................#
#..................##..................#
#..................##..................#
#..................##..................#
#..................##..................#
########################################